####################
#x................x#
#.                .#
#.   ###     ###  .#
#.                .#
#.        ^       .#
#.   ###     ###  .#
#.                .#
#x................x#
####################
