##################
#...#........#...#
#.#...##..##...#.#
#.##.#......#.##.#
#..#...#..#...#..#
##.##.#....#.##.##
##....######....##
##.##........##.##
##.#####..#####.##
#...##......##...#
#.#....####....#.#
#...##......##...#
##################
