####################
#x****************x#
#*                *#
#*   ###     ###  *#
#*                *#
#*        ^       *#
#*   ###     ###  *#
#*                *#
#x****************x#
####################
