#######################
#..........#..........#
#.### ###..#..### ###.#
#.### ##.......## ###.#
#........#####........#
#.###.#....#....#.###.#
#.....#### # ####.....#
#####.#.........#.#####
#  ##.#.##   ##.#.##  #
#####.#.#     #.#.#####
#####...#     #...#####
#####.#.#     #.#.#####
#  ##.#.#######.#.##  #
#####.#....^....#.#####
#........#####........#
#.### ##...#...## ###.#
#...#...... ......#...#
### # #.#######.# #.###
#.....#....#....#.....#
#.########.#.########.#
#.....................#
########################