#######################
#..........#..........#
#.### ###..#..### ###.#
#.### ##.......## ###.#
#........#####........#
#.###.#....#....#.###.#
#.....#### # ####.....#
#####.#.........#.#####
   ##.#.##   ##.#.##
#####.#.#     #.#.#####
#####...#  M  #...#####
#####.#.#     #.#.#####
   ##.# #######.#.##
#####.#....^....#.#####
#........#####........#
#.### ##...#...## ###.#
#...#...... ......#...#
### # #.#######.# #.###
#.....#....#....#.....#
#.########.#.########.#
#.....................#
#######################